################                                                            ################
#..............#                                                            #..............#
#..............#                                                            #..............#
#..............#                                                            #..............#
#..............##############################################################..............#
#..........................................................................................#
#..........................................................................................#
#..........................................................................................#
#..........................................................................................#
#..........................................................................................#
#..........................................................................................#
#..............##..##..##..##..##..##..##..##......##..##..##..##..##..##..##..............#
#..............#                                                            #..............#
#..............#                                                            #..............#
#..............#                                                            #..............#
#####......#####                                                            #####......#####
    #......#                                            #..#    ####    ####    #......#    
    ........                                            #...    ....    ...#    #......#    
    ........                                            #...    ....    ...#    #......#    
    #......#                                            #..#    #..#    #..#    #......#    
    #......#    ####################        ###..###                            #......#    
    ........    ...................#        #......#                            #......#    
    ........    ...................#        #......#    #..#    #..#    #..#    #......#    
    #......#    #################..#        #..&&...    ....    #..#    #..#    #......#    
    #......#                                #..&&...    ....    #..#    #..#    #......#    
    ........                     &&         #......#    #..#    #..#    #..#    #......#    
    ........                     &&         #......#                            #......#    
    #......#                                #......#                            #......#    
    #......#    #################..#        #......#    #..#    ####    #..#    #......#    
    ........    ...................#        #......#    #...    ...#    #&&#    .......#    
    ........    ...................#        #......#    #...    ...#    #&&#    .......#    
    #......#    ####################        #......#    ####    #..#    ####    #......#    
    #......#                                #......#                            #......#    
    ........                                #......#                            #......#    
    #......#                                #......#                            #......#    
#####......#####                            #......#                        #####......#####
#..............#                            #......#                        #..............#
#..............#                            #......#                        #..............#
#..............#                            #......#                        #..............#
#..............##############################......#############            #..............#
#...............................................................            ...............#
#...............................................................            ...............#
#......&&.......................................................            .......&&......#
#......&&.......................................................            .......&&......#
#...............................................................            ...............#
#...............................................................            ...............#
#..............#################################################            #..............#
#..............#                                                            #..............#
#..............#                                                            #..............#
#..............#                                                            #..............#
################                                                            ################